NonAgrarian Society - Do not make any farm until imperial age and win - Acelgaman
An Explosive Victory - Win using only units that explode - BinnyBongBaron
And My Axe - Make only throwing axeman + win - BinnyBongBaron
Nomadic Heritage - Delete your starting TC in dark age and win - BinnyBongBaron
The Last Samuwrang - Win by creating only samurai, the first samurai created must survive - BinnyBongBaron
A Barrel of Scorpions - Win with 50+ scorpions alive at time of victory - cadaHB
A Towering Achievement - Make 25 Siege towers and win - CadaHB
Right To Jail - Win with a wall enclosing your opponent’s base (buildings) - cadaHB
A Wooden Economy - Win without gathering any resource but wood after reaching feudal age - chpstkx
Bounty D - Win without making military units - chpstkx
Bounty F - Win on Arena in Feudal Age - chpstkx
Centers of Attention - Win with 25 TCs alive or more at time of victory - chpstkx
Dark Age Tactician - Win in Dark age - chpstkx
The Benevolent Invader - Send all your sheep to your opponent and win - chpstkx
Clear Cutting - Cut an entire enemy forest and win - chpstkx
A Real All In - Delete your TC in Castle age + win. No additional TCs Allowed - DopingPositivo
Living On The Edge - All houses must touch the outside of the map (No Huns) - EmperorAlHasan
You Can Run But You Can’t Hide - Win without walls or garrisoning any units - ens0099
Jam Your BBC In Their Base - Win using only vils and BBC (must make at least 10 BBC), no Burgundians - Falrus
Earthquake Champion - Win a game with 0 buildings alive at time of victory - fi7li
Killager - Get 3 kills with one of your starting villagers and win - Fi7li
Bounty H - Make Xolotol Warriors and Win - FlauschFuchs
Bounty C - Delete all starting vills and scout and win - FortuneFinder
Inefficient Construction - All resource camps must be built touching the wrong resource + win - FreakinAndy
Fasterest Castle - Get to Castle Age in Under 11 Minutes + win - Funny_liquid
OK Boomer - No clicking up to castle age until 100 villagers are alive and win - Funny_liquid
Bounty I - Build a Wall that touches both starting TCs and win - GurasTobbyBufas
F It, Make War Elephants - Win with war elephants as the only produced unit - Homebrandhadouken
The End of The Rainbow - Wall in your main gold + win - Homebrandhadouken
Trappers - Wall at least 3 wild animals in + win - Homebrandhadouken
Custom Renovations - Replace 5 enemy buildings with your own + win - Imperator_DX
Jeff’s Strategy - Collect at least 1 stone from every stone pile on the map and win - Jikredible1
Get The Point? - Only spears allowed + win - JimmyReinor
Kiss Me, I’m 30 Mangonels - Have 30 Mangonels alive simultaneously at any point + win - JimmyReinor
Lubov’s Discount Day - Make at least 50 militia in dark age and win - JimmyReinor
Militaristic Society - Win without any villagers alive at time of victory - JimmyReinor
Militaristic Society2: Electric Boogaloo - Win without any villagers alive at time of victory (No Burgundians) - JimmyReinor
That’s Not What I Meant By “Slinging” - Make only slingers and win (must make at least 10) - JimmyReinor
The Woad To Bublin - Win with woads as the only produced military unit - JimmyReinor
Religious Generosity - Drop at least 3 relics within LOS of your opponent’s starting TC + win - Jojo_Baum
Might of Midas - Every military building must be touching a gold pile + win - KickerSemden
Wooden Allergy - Win without gathering wood - Kongen_42
A Turtle In The Desert - Get a kill with a turtle ship on a land map and win - kongen_42
Bride of Greg - With a male villager and a monk go forward to convert an enemy female villager and venture back to the starting monastery, all three must survive the road back + win - kongen_42
I Draw The Line - Win with a completed wall that touches parallel outsides of the map - kongen_42
Long Live The Warrior King - Get 5 kills with your starting scout, keep it alive + win - kongen_42
A Clean Victory - Have 50 genitours alive and win - Mangudied
Actual Gatekeeping - Every military unit must pass through the same gate and win - Mangudied
Never Go Full Petard - Build at least 17 petards + win. No other military allowed - Mangudied
Spelling Rocks - Spell your opponent’s name (or grathwrang) in stone walls and win - Mangudied
Build It Nice Build It Twice - All buildings must be built touching in pairs + win - MonkeyBurner
Indecent Exposure - No Loom, delete walls, no castle on arena and win - Mr_greeeeen_
Housing Crisis - Produce no more than 15 villagers and win - Neil Heima
Chpstx Stylez - Win a game where you TC drop the opponent before castle age (no HP/TC bonus civs) - Neil_heima
No Hitting - Deal 0 melee damage + win - Nesalami
No Khmercy - Create only ballista elephants and win - Nili_AOE
Old Man Strength - Get to 100HP Aztec Monks, produce at least 20 + win - pax_au_telamanus
Cantankerous Clergy - Win producing only warrior priest - PrideGaming96
Inclined To Build - Houses may only be placed on hills or elevations and win - PrideGaming96
Siege The Day! - Win producing only siege units - Princessgadz
An Uneducated Populace - No research allowed and win - RedNeal
Everything’s Coming Up Millhouse! - Win using only folwarks as houses - RedNeal314
One Of A Kind - Win producing only unique units - RS,Newp9772
Resistance Is Feudal - Win in feudal age on Arabia - RS,Newp9772
No Touching - No structures are allowed to touch + win - SantaDriver
Bounty B - Trade with enemy for a total of 500 gold and win - Shixo
The Cautious Shepherd - Build a stone pen for your sheep, they all must survive in the pen + win - Shixo
The Stone Hydra - Place 3 castles simultaneously, complete the castles, keep them alive + win - smarttguyy_
Bounty E - Delete Wall on Arena and Win - Supermonkeycar3000
Bounty J - Win without loom on an open map - Supermonkeycar3000
Bounty A - Win a game without building a lumbercamp - Survivalist
Greg The Builder - All buildings other than farms must be built using the same villager and win - TheRealHigh
Wonderwall - Win with a completed wall around your town that includes a wonder - TheRealHigh
Archers Suck - Win as Spanish or Bulgarians with 60 archers alive at time of victory - time2thinkmore
Bounty G - Build a Wonder - WeanDinchester
Ghost Town - Delete your starting TC and rebuild it on a neutral gold/stone before Feudal and win - KorDimon
OnlyFarms - Win using only farms as a food source - Neil Heima
A Perfect Game - Win without losing a villager and without idling your TC - Mangudied(1st)
Conservative Construction - Only build 4 buildings that are not houses or TCs and win - David810s  
Are you TheViper? - Wall in at least 3 of your opponent's units and win - DJSapsan
Garbage Garbage - Win as turks using only spears and skirms (siege allowed) - Time2Think
Andean Revolution - Fast Castle no creating military as Incas and win - SMVBluestar
Axe Throwing Contest - Win using only Throwing Axe Men - chpstkx
A Barrel of Scorpions 2 - Produce only scorpians and win - Avild
Teutonic Scouting - Have 50 scouts alive at time of victory as Teurons - Pvasnunes
What's Yours is Mine - Only collect gold/stone from the opponents piles and win - KorDimon
Basically the Huns - No Feudal Age until you reach the pop limit in houses and win - Mathias_K92
Feudalsphoru - Make no villagers once reaching feudal age and win - pvasnunes(1st)
The Ultimate Warrior - One Unit must have 20 kills at any time survive and win - Da_Comanda
Basically a Trebuchet - Kill 5 buildings or 1 castle with only vilagers and win - neil_heima
Hot Camels In Your Area - Produce Only flaming Camels and Win (siege allowed)
Feuedalsphoru 2 - Make no villagers once reaching feudal age and win, no going up to castle - chpstkz
Nice town, I'll take it! - Convert 15 building and win - DJSapsan
His Names Greg - Construct at least 1 castle with 1 villager named Greg (who survives) within line of sight of the opponent and win - Spring
Santa's Workshops - Win producing only units from siege workshops (must produce 1 of each and must make 1 monk) - Kevin FOJ
O Christmas Tree - Draw a Christmas tree with palisades and win - mchill37
Three Wise Men - Use 3 monks to drop 3 relics at your opponents starting TC and win - Time2think
Its Christmastime.... for the opponent - Send all of your sheep to the opponent and win - Kevin FOJ
Evil Greg and his Henchmen - Construct a castle using only converted vils in range of an enemy TC and win - Mr. Greeeeen
Quit touching me - Build a castle that touches an opponents finished Castle and win - chpstkx
Steve's Choice (mangudai) - Steve will select a random unit; produce only that unit and win - rarelypaidforemotes
The Woad to Dublin 2 - Win with only woads produced - misc_leopard
The One Ring - Select a villager named "Frodo" to touch the enemy TC and survive and win - CadaHB
The Two Towers - Produce only militia and two towers and win - chpstkx
Couchlocked - APM must drop to 0 for 4 minutes and 20 second and win - chpstkx
Feudal Flemish Fisticuffs - Produce only Flemish militia remain in feudal and win - chpsktx
EEEEEEEEEEEEEEEEEEEEagles - Kill a TC in Feudal age using only Eagles and win - jimmythicks
Rocket the Kasbah - Produce only Rocket Carts and win - DJSapsan
Oh My God that is Fire... Lancer  - Produce only Fire Lancers and win - Smarttguyy